基础信息
accountMgmt: 账号管理
shopMgmt: 店铺授权
expressMgmt: 物流管理
customerMgmt: 会员管理
printTemplate: 打印模板
supplierMgmt: 供应商
companySetting: 基础设置

商品管理
productMgmt: 商品资料
productRecycled: 回收站

订单管理
orderManually: 手工开单
shopOrderList: 平台订单
orderReview: 订单客审
orderFinancialReview: 订单财审
orderCustoms: 订单报关
orderDist: 分销订单
orderHold: 异常订单
orderQuery: 订单查询

售后管理
aftersaleReceipt: 包裹签收
aftersaleMgmt: 售后单处理

发货管理
pickPrint: 订单打印
pickCheck: 扫描验货
pickWeigh: 订单称重
pickShip: 扫描发货

库存管理
whsMgmt: 仓库管理
pickLocation: 库位管理
stockTransfer: 库存调拨
goodsReceipt: 杂项入库
goodsIssue: 杂项出库
purchaseReceipt: 采购收货
purchaseReturn: 采购退货
stockTaking: 库存盘点

采购管理
purchaseOrder: 采购订单
purchasePayment: 采购付款

报表分析
productSummary: 商品资料统计报表
salesSummary: 销售订单统计报表
stockSummary: 出入库统计报表
stockJournalSummary: 出入库明细报表
stockInvoicingSummary: 进销存统计报表

报关设置
customsSetting: 海关备案设置